{
    "level" : {
        "name" : "third level",
        "board" : [
            ["X","X","X","X","X","X","X","X","X","X","X","X","X"],
            ["X","X","X","X","X","A","A","A","X","X","X","X","X"],
            ["X","X","X","X","X","X","A","X","X","X","X","X","X"],
            ["X","A","A","A","A","X","A","X","A","A","A","A","X"],
            ["X","A","A","A","A","X","A","X","A","A","A","A","X"],
            ["X","X","X","X","X","X","X","X","X","X","X","X","X"],
            ["X","X","X","X","X","X","X","X","X","X","X","X","X"],
            ["A","X","A","A","X","B","B","B","X","A","A","X","A"],
            ["A","A","X","A","X","A","A","A","X","A","X","A","A"],
            ["A","A","X","X","X","X","X","X","X","X","X","A","A"],
            ["X","X","C","C","C","C","C","C","C","C","C","X","X"],
            ["X","X","X","X","X","X","X","X","X","X","X","X","X"],
            ["X","X","X","X","X","X","X","X","X","X","X","X","X"],
            ["X","X","X","X","X","X","X","X","X","X","X","X","X"],
            ["X","X","X","X","X","X","X","X","X","X","X","X","X"],
            ["X","X","X","X","X","X","X","X","X","X","X","X","X"],
            ["X","X","X","X","X","X","X","X","X","X","X","X","X"],
            ["X","X","X","X","X","X","X","X","X","X","X","X","X"]
        ]
    }
}